F 1, 105, 105
EA asset/purplestone.XPM

WE asset/redbrick.XPM




SO asset/greystone.XPM


NO asset/bluestone.XPM













C 105,105,105















11111111111111111111111111111111111111111111111111111111111111111111111111111111111111111111111111111111111111111
1       100000000011000000000000101010110101010001010101101010101010111111111111111111111111111111111111111111111
1       10110000011100000000000011111011111111101110101001000111110111                                          1
1       1001000000200W000000000011111011111111101110101001000111110111111111111111111       111111111111111111111
111111111011000001110000000000001    1         1 1 1 1 11 111     1                11               1           1
100000000011000001110111111111111                1                                 11       111111111           1
11110111111111011100000010001                    1                                 11       111111111           1
111101111111110111010100100011                   1             1                  11       100000001            1
1100000011010101110100001000001                  1            101                 11       111111111            1
100000000000000011000000100011                   1             1                  11                            1
1000000000000001101010010001                    1                                 11                           1
11000001110101011111011110101111111111111111111111                                 11                           1
11110111 1110101 10111101000100000000000000001                                     11                           1
1   1       1 1   1    1 111 11111111111111111                                     11                           1
1                            11111111111111111111111111111111111111111111111111111111                           1
1                                                                                                             111
1                                                                                                             101
11111111111111111111111111111111111111111111111111111111111111111111111111111111111111111111111111111111111111111







