

F 220,    100,0












C 225,30,0






EA asset/purplestone.XPM

WE asset/redbrick.XPM




SO asset/greystone.XPM


NO asset/bluestone.XPM








     1111
     1001
     1011
     1001
111111011
100000011
111101101
111101101
110000N11
11110111 
11111111 












