
F 1, 105, 105
EA                   asset/purplestone.XPM          

WE asset/redbrick.XPM 




SO asset/greystone.XPM


NO asset/bluestone.XPM

C 128,128,128













111111111111111111111111111111111111111111111111111111111111111111111111111111111111111111111111
1W0002000000000000000000000000000000000000000000000000000000000000000000000000000000000000000001
111111111111111111111111111111111111111111111111111111111111111111111111111111111111111111111111


