
EA asset/purplestone.XPM

WE asset/redbrick.XPM


SO asset/greystone.xpm


NO asset/bluestone.XPM


F 0, 0,0












C 0,0,0
1
11111
1N101
111111















