EA asset/purplestone.XPM

WE asset/redbrick.XPM




SO asset/greystone.XPM


NO asset/bluestone.XPM

F 220,    100,0












C 225,30,0














1111111111111
100N000000001
1100000011111
1100000011111
1100000021 11
1100000011111
1100000011111
1100000011111
1111111111111









