
EA asset/purplestone.XPM

WE asset/redbrick.XPM




SO asset/greystone.XPM


NO asset/bluestone.XPM

F 128,128,128











C 105,105,105















        111111111111111
        100000000011001
        101100000110001
        100100000000001
11111111101100000100001
10000000001100000111111
11110111111111011101    
11110111111111211101    
11000000110101011101    
10000000000000001101    
10000000000000001101    
11000001110101011111  
1111N111 1110101 101    
11111111 1111111 111    












