
EA asset/purplestone.XPM

WE asset/redbrick.XPM




SO asset/greystone.XPM


NO asset/bluestone.XPM
F 220,    100,0

C 225,30,0
11111111
10100001
10000011
10000011
10000111
10000201
10N10101
11111111
11111111
