
F 1, 105, 105
EA asset/purplestone.XPM

WE asset/redbrick.XPM




SO asset/greystone.XPM


NO         asset/bluestone.XPM           

C              128,128,128          













111111111
101000011
101000011
10100001111111
10110000000001
10011101111111
10000201111101
10111101111101
10111100000001
10111111111111
1N1
111
