
EA asset/purplestone.XPM

WE asset/redbrick.XPM




SO asset/greystone.XPM


NO asset/bluestone.XPM
F 220,    100,0
C 225,30,0
111111111
101000101
100000101
100000201
100000101
100001101
10N101001
111111101
111111111























