EA asset/purplestone.XPM

WE asset/redbrick.XPM




SO asset/greystone.XPM


NO asset/bluestone.XPM

F 220,    100,0












C 225,30,0














111111111111111111111111
100000000000N00000000001
111111111100000001111111
111111111111110111111111









