
EA asset/purplestone.XPM
F 220,    220,12
C 3,3,30





WE asset/redbrick.XPM




SO asset/greystone.XPM


NO asset/bluestone.XPM

111111111111111111111111
100000000000N00000000001
111111111100000001111111
1111111111111111111111111111111111111111
111111111111111111111111

1








