
EA asset/purplestone.XPM

WE asset/redbrick.XPM




SO asset/greystone.XPM


NO asset/bluestone.XPM

F 220,    100,0












C 225,30,0














                  111111           
        1111111111100001111111111  
        1000000000110000000000001  
        101100000111001111100000111
        100100000000001   100000001
111  111101100000111000   100000001
10111100001100000111001   101111111
11110111111111011100001   101      
11110111111111011101001111101      
11000001111111011100000010001      
10000001    10001100000010001      
10000001111110001101010010001      
11000001110101011111011110N0111    
11110111 1110101 101111010001      
11111111 1111111 111111011111      
                      111          











